0022222222222222
0000000000000002
2000000000000002
2000203000000002
2000200000030002
2000202000000002
2000000000000302
2000000001000002
2000000000000002
2000003000001002
2000000000000002
2000000001000002
2000010000000002
3000000000000002
3000000000000000
3333222222022200
