0011111111111111
0000000000000001
1000000000000001
1000101000000001
1000100000010001
1000101000000001
1000000000000101
1000000001000001
1000000000000001
1000001000001001
1000000000000001
1000000001000001
1000010000000001
1000000000000001
1000000000000000
1111111111011100
